11111111111111111111
1   111        11 E1
1   1 1        1  11
1 S 1 1   111  1  11
1   1 1   1  1 1  11
1   111   111  1  11
1                111
11111111111111111111
